##########################################
#.......#.............#............#.....#
#.......#..........####..................#
#.......#.....................######.....#
#.......#..........####.......#..........#
#..................#..........#..........#
###############################..#########
#....................#........#..........#
#.............#......#........#..##......#
#...###########..#####.....#..#.....###..#
#...#.........#............#..#...###....#
#...#....#....#............#..#.......####
#........#....##############.............#
############........#......###############
#..%#......#........#....................#
#...#......#...............#.............#
#..##...#..#........###################..#
#...#...#..##########...#.........#...#..#
##..#...#..#......#......#....#....#......#
#.......#......#....#........#...........#
##########################################