##############
#............#
#............#
#....######..#
#....#....#..#
#.........#.%#
##############